....................
....................
....................
....##########......
....#........#......
....#........#......
....#........#......
....#........#......
....................
....................
.............#......
.............#......
.............#......
.............#......
.............#......
....................
....................
....................
....................
....................