....................
....................
....................
....#........#......
....#........#......
....#........#......
....#........#......
....#........#......
....##########......
.............#......
.............#......
.............#......
.............#......
.............#......
.............#......
....................
....................
....................
....................
....................
