....................
....................
...####.............
...##...............
...#................
...######...........
........#...........
........#...........
....................
....#...........#...
....#...........#...
....#...........#...
................#...
....................
............#.......
............#.......
....................
....................
....................
....................
